8 8
11111111
00100101
10000111
11010111
11000011
11111011
11111000
11111111